6,6,6,6,6,6,6,6,6,6,6,6,6,6,6,6,6,6,6,6,6,6,6,6,6,6,6,6,6,6,6,6,6,6,6,6,6,6,6,6,6,6,6,6,6,6,6,6,6,6,6,6,6,6,6,6,6,6,6,6,6,6,6,6,6,6,6,6,6,6,6,6,6,6,6,6,6,6,6,6,6,6,6,6,6,6,6,6,6,6,6,6,6,6,6,6,6,6,6,6
6,2,2,2,2,2,2,2,2,2,2,2,2,2,2,2,2,2,2,2,2,2,2,2,2,2,2,2,2,2,2,2,2,2,2,2,2,2,2,2,2,2,2,2,2,2,2,2,2,2,2,2,2,2,2,2,2,2,2,2,2,2,2,2,2,2,2,2,2,2,2,2,2,2,2,2,2,2,2,2,2,2,2,2,2,2,2,2,2,2,2,2,2,2,2,2,2,2,2,6
6,2,2,2,2,2,2,2,2,2,2,2,2,2,2,2,2,2,2,2,2,2,2,2,2,2,2,2,2,2,2,2,2,2,2,2,2,2,2,2,2,2,2,2,2,2,2,2,2,2,2,2,2,2,2,2,2,2,2,2,2,2,2,2,2,2,2,2,2,2,2,2,2,2,2,2,2,2,2,2,2,2,2,2,2,2,2,2,2,2,2,2,2,2,2,2,2,2,2,6
6,2,2,2,2,2,0,2,2,2,2,2,2,2,2,2,2,2,2,2,2,2,2,2,2,2,2,2,2,2,2,2,2,2,2,2,2,2,2,2,2,2,2,2,5,2,2,2,2,2,2,2,2,2,2,2,2,2,2,2,2,2,2,2,2,2,2,2,2,2,2,2,2,2,2,2,2,2,2,2,2,2,2,2,2,2,2,2,2,2,2,2,2,2,2,2,2,2,2,6
6,2,2,2,2,2,0,2,2,2,2,5,2,2,2,0,0,0,0,2,2,2,2,2,2,2,2,2,2,5,2,2,0,2,2,2,2,2,2,2,2,2,2,2,5,2,2,2,2,2,2,0,2,2,2,2,0,2,2,2,2,2,2,2,2,2,2,2,2,2,2,2,2,2,2,2,2,2,2,2,2,2,2,2,2,2,2,2,2,2,2,2,2,2,2,2,2,2,2,6
6,2,2,2,2,2,0,2,2,2,2,5,2,2,2,2,2,2,0,0,2,2,2,2,2,2,2,2,2,5,2,2,2,0,0,0,0,0,2,2,2,2,2,2,5,2,2,2,2,0,0,2,2,2,2,2,0,2,2,2,2,2,2,2,2,2,2,2,2,2,0,0,0,2,2,2,2,2,2,2,2,2,2,2,2,2,2,2,2,2,2,2,2,2,2,2,2,2,2,6
6,2,2,2,2,0,2,2,2,2,2,5,2,2,2,2,2,2,0,0,2,2,2,2,2,2,2,2,2,5,2,2,2,2,2,2,2,2,0,2,2,2,2,5,2,2,2,2,2,0,2,2,2,2,2,0,2,2,2,2,2,2,2,2,2,2,2,2,2,0,0,2,2,0,2,2,2,2,2,2,2,2,2,2,2,2,2,2,2,2,0,0,0,0,0,0,2,2,2,6
6,2,2,2,2,0,2,2,2,2,2,5,2,2,2,2,0,0,0,2,2,2,2,2,2,2,2,2,2,5,5,2,2,2,2,2,2,0,0,2,2,2,2,5,2,2,2,2,0,0,2,2,2,2,2,0,2,2,2,2,2,2,2,2,2,2,2,2,2,0,2,2,2,2,2,2,2,2,2,2,2,2,2,2,2,2,2,2,0,0,2,2,2,2,2,2,2,2,2,6
6,2,2,2,2,0,2,2,2,2,5,2,2,2,2,0,0,2,2,2,2,2,2,2,2,2,2,2,2,5,2,2,2,2,2,2,0,0,2,2,2,2,5,5,2,2,2,2,0,0,2,2,2,2,0,0,2,2,2,2,2,2,2,2,2,2,2,2,2,0,2,2,2,2,2,2,2,2,2,2,2,2,2,2,2,2,2,0,0,2,2,2,2,2,2,2,2,2,2,6
6,2,2,2,2,2,2,2,2,2,5,2,2,2,2,0,2,2,2,2,2,2,2,2,2,2,2,2,2,5,2,2,2,2,2,2,0,2,2,2,2,2,5,2,2,2,2,2,2,0,0,0,0,0,2,0,2,2,2,2,2,2,2,2,2,2,2,2,2,0,0,2,2,2,2,2,2,2,2,2,2,2,2,2,2,2,0,2,2,2,2,2,2,2,2,2,2,2,2,6
6,2,2,2,2,2,2,2,2,2,5,2,2,2,2,0,0,0,0,0,2,2,2,2,2,2,2,2,2,5,2,2,2,2,2,2,0,0,2,2,2,2,5,2,2,2,2,2,2,2,2,2,2,2,0,2,2,2,2,2,2,2,2,2,2,2,2,2,2,2,0,2,2,2,2,2,2,2,2,2,2,2,2,2,2,0,2,2,2,2,2,2,2,2,2,2,2,2,2,6
6,2,2,2,2,2,2,2,2,2,5,2,2,2,2,2,2,2,2,2,2,2,2,2,2,2,2,2,2,5,2,2,2,2,2,2,2,0,2,2,2,2,5,2,2,2,2,2,2,2,2,2,2,2,0,2,2,2,2,2,2,2,2,2,2,2,2,2,2,2,0,2,2,2,2,2,2,2,2,2,2,2,2,2,0,0,2,2,2,2,2,2,2,2,2,2,2,2,2,6
6,2,2,2,2,2,2,2,2,2,5,2,2,2,2,2,2,2,2,2,2,2,2,2,2,2,2,2,5,2,2,2,2,2,2,2,0,0,2,2,2,5,2,2,2,2,2,2,2,2,2,2,2,2,0,2,2,2,2,2,2,2,2,2,2,2,2,2,2,2,0,2,2,2,2,2,2,2,2,2,2,2,2,2,0,2,2,2,2,2,2,2,2,2,2,2,2,2,2,6
6,2,2,2,2,2,5,5,5,5,5,5,5,5,2,2,2,2,2,2,2,2,2,2,2,2,2,2,5,2,2,2,2,2,2,0,0,2,2,2,2,5,2,2,2,2,2,2,2,2,2,2,2,2,0,2,2,2,2,2,2,2,2,2,2,2,2,2,2,0,0,2,2,2,2,2,2,2,2,2,2,2,2,0,0,0,0,2,2,2,2,2,2,2,2,2,2,2,2,6
6,2,2,2,2,2,2,2,2,2,5,2,2,2,5,5,5,5,5,5,2,2,2,2,2,2,2,2,5,2,2,2,2,2,0,0,2,2,2,2,2,5,2,2,2,2,2,2,2,2,2,2,2,0,2,2,2,2,2,2,2,2,2,2,2,2,2,2,2,0,2,2,2,2,2,2,2,2,2,2,2,2,2,0,2,2,2,0,2,2,2,2,2,2,2,2,2,2,2,6
6,2,2,2,2,2,2,2,2,2,5,2,2,2,2,2,2,2,2,2,5,5,5,2,2,2,2,5,2,2,2,2,2,0,2,2,2,2,2,2,2,5,2,2,2,2,2,2,2,2,2,2,2,0,2,2,2,2,2,2,2,2,2,2,2,2,2,0,0,2,2,2,2,2,2,2,2,2,2,2,2,2,2,0,0,2,0,0,2,2,2,2,2,2,2,2,2,2,2,6
6,2,2,2,2,2,2,2,2,2,5,2,2,2,2,2,2,2,2,2,2,2,2,5,5,5,5,5,2,2,2,2,2,2,2,2,2,2,2,2,2,5,2,2,2,2,2,2,2,2,2,2,2,2,2,2,2,2,2,2,2,2,2,2,2,2,2,2,2,2,2,2,2,2,2,2,2,2,2,2,2,2,2,2,0,0,0,2,2,2,2,2,2,2,2,2,2,2,2,6
6,2,2,2,2,2,2,2,2,2,2,5,2,2,2,2,2,2,2,2,2,2,2,2,2,2,2,2,5,5,5,5,5,5,5,5,2,2,2,2,2,5,2,2,2,2,2,2,2,2,2,2,2,2,2,2,2,2,2,2,2,5,2,2,2,2,2,2,2,2,2,2,2,2,2,2,2,2,2,2,2,2,2,2,2,2,2,2,2,2,2,2,2,2,2,2,2,2,2,6
6,2,2,2,2,2,1,2,2,2,2,2,2,2,2,2,2,2,2,2,2,2,2,2,2,2,2,2,2,2,2,2,2,2,2,5,5,5,5,5,5,5,5,5,5,5,2,2,2,2,2,2,2,2,2,2,2,2,2,2,2,5,2,2,2,2,2,2,2,2,2,2,2,2,2,2,2,2,2,2,2,2,2,2,2,2,2,2,2,2,2,2,2,2,2,2,2,2,2,6
6,2,2,2,2,2,1,2,2,2,2,2,2,2,2,2,1,1,1,1,1,2,2,2,2,2,2,2,2,2,2,2,2,2,2,2,2,2,2,2,2,5,2,2,2,2,2,2,2,2,2,2,2,2,2,2,2,2,2,2,2,5,2,2,2,2,2,2,2,2,2,2,2,2,2,2,2,2,5,2,2,2,2,2,2,2,2,2,2,2,2,2,2,2,5,2,2,2,2,6
6,2,2,2,2,1,2,2,2,2,2,2,2,2,2,1,2,2,2,2,1,2,2,2,2,2,2,2,2,2,2,2,2,2,2,2,2,2,2,2,2,5,2,2,2,2,2,2,2,2,2,2,2,2,2,2,2,2,2,2,2,5,2,2,2,2,2,2,2,2,2,2,2,2,2,2,2,5,2,2,2,2,2,2,2,2,2,2,2,2,2,2,2,2,5,2,2,2,2,6
6,2,2,2,2,1,2,2,2,2,2,2,2,2,2,2,2,2,2,1,1,2,2,2,2,2,2,2,2,2,2,2,2,2,1,1,1,1,2,2,5,5,2,2,2,2,2,2,2,1,2,2,2,2,2,1,2,2,2,2,2,5,2,2,2,2,2,2,2,2,2,2,2,2,2,2,2,5,2,2,2,2,2,2,2,2,2,2,2,2,2,2,2,2,5,2,2,2,2,6
6,2,2,2,2,1,2,2,2,2,2,2,2,2,2,2,2,2,2,1,2,2,2,2,2,2,2,2,2,2,2,1,1,1,2,2,1,1,2,2,2,2,2,2,2,2,2,2,2,1,2,2,2,2,1,2,2,2,2,2,2,5,2,2,2,2,2,2,1,1,1,2,2,2,2,2,2,5,2,2,2,2,2,2,2,2,2,2,2,2,2,2,2,2,5,2,2,2,2,6
6,2,2,2,2,1,2,2,2,2,2,2,2,2,2,2,2,2,1,2,2,2,2,2,2,2,2,2,2,2,2,2,2,2,2,1,1,2,2,2,2,2,2,2,2,2,2,2,2,1,2,2,2,2,1,2,2,2,2,2,2,5,2,2,2,2,2,1,1,2,2,1,2,2,2,2,2,5,2,2,2,2,2,2,2,2,2,2,2,2,2,2,2,2,5,2,2,2,2,6
6,2,2,2,2,1,2,2,2,2,2,2,2,2,2,2,2,2,1,2,2,2,2,2,2,2,2,2,2,2,2,2,2,2,1,1,2,2,2,2,2,2,2,2,2,2,2,2,2,1,2,2,1,1,1,2,2,2,2,2,2,2,5,2,2,2,2,1,1,2,2,2,2,2,2,2,2,5,2,2,2,2,2,2,2,1,1,1,1,1,2,2,2,2,5,2,2,2,2,6
6,2,2,2,2,2,2,2,2,2,2,2,2,2,2,2,2,2,1,2,2,2,2,2,2,2,2,2,2,2,2,2,2,2,1,1,2,2,2,2,2,2,2,2,2,2,2,2,2,1,1,1,1,2,1,2,2,2,2,2,2,2,5,2,2,2,2,2,1,2,2,2,2,2,2,2,2,5,2,2,2,2,2,2,1,1,2,2,2,2,1,2,2,2,5,2,2,2,2,6
6,2,2,2,2,2,2,2,2,2,2,2,2,2,2,2,2,2,1,1,1,1,2,2,2,2,2,2,2,2,2,2,2,2,2,1,1,2,2,2,2,2,2,2,2,2,2,2,2,2,2,2,2,2,1,2,2,2,2,2,2,2,5,2,2,2,2,2,1,1,2,2,2,2,2,2,2,5,2,2,2,2,2,2,1,2,2,2,2,2,2,2,2,2,5,2,2,2,2,6
6,2,2,2,2,2,2,2,2,2,2,2,2,2,2,2,2,2,2,2,2,1,1,2,2,2,2,2,2,2,2,2,2,2,2,2,1,2,2,2,2,2,2,2,2,2,2,2,2,2,2,2,2,1,2,2,2,2,2,2,2,2,5,2,2,2,2,2,2,1,2,2,2,2,2,2,2,5,2,2,2,2,2,1,2,2,2,2,2,2,2,2,2,2,5,2,2,2,2,6
6,2,2,2,2,2,2,2,2,2,2,2,2,2,2,2,2,2,2,2,2,2,2,2,2,2,2,2,2,2,2,2,2,2,2,2,1,2,2,2,2,2,2,2,2,2,2,2,2,2,2,2,2,1,2,2,2,2,2,2,2,2,5,2,2,2,2,2,2,1,2,2,2,2,2,2,2,5,2,2,2,2,2,1,2,2,2,2,2,2,2,2,2,2,5,2,2,2,2,6
6,2,2,2,2,2,2,2,2,2,2,2,2,2,2,2,2,2,2,2,2,2,2,2,2,2,2,2,2,2,2,2,2,2,2,1,2,2,2,2,2,2,2,2,2,2,2,2,2,2,2,2,2,1,2,2,2,2,2,2,2,2,5,2,2,2,2,2,2,1,2,2,2,2,2,2,2,5,2,2,2,2,2,1,2,2,2,2,2,2,2,2,2,2,5,2,2,2,2,6
6,2,2,2,2,2,2,2,2,2,2,2,2,2,2,2,2,2,2,2,2,2,2,2,2,2,2,2,2,2,2,2,2,1,1,1,2,2,2,2,2,2,2,2,2,2,2,2,2,2,2,2,2,1,2,2,2,2,2,2,2,2,5,2,2,2,2,2,2,1,2,2,2,2,2,2,2,5,2,2,2,2,2,1,1,2,2,2,2,2,2,2,2,2,5,2,2,2,2,6
6,2,2,2,2,2,2,2,2,2,2,2,2,2,2,2,2,2,2,2,2,2,2,2,2,2,2,2,2,2,2,2,2,1,2,2,2,2,2,2,2,2,2,2,2,2,2,2,2,2,2,2,1,2,2,2,2,2,2,2,2,2,5,2,2,2,2,2,1,1,2,2,2,2,2,2,2,5,2,2,2,2,2,1,2,1,1,2,2,2,2,2,2,2,5,2,2,2,2,6
6,2,2,2,2,2,2,2,2,2,2,2,2,2,2,2,2,2,2,2,2,2,2,2,2,2,2,2,2,2,2,2,2,2,2,2,2,0,0,2,2,2,2,2,2,2,2,2,2,2,2,2,1,2,2,2,2,2,2,2,2,2,5,2,2,2,1,1,1,2,2,2,2,2,2,2,2,5,2,2,2,2,2,1,1,2,1,2,2,2,2,2,2,2,5,2,2,2,2,6
6,2,2,2,2,2,3,2,2,2,2,2,2,2,2,2,2,2,2,2,2,2,2,2,2,2,2,2,2,2,2,2,2,2,2,2,2,2,0,0,0,0,0,0,2,2,2,5,5,2,2,2,2,2,2,2,2,2,2,2,2,2,5,2,2,1,2,2,2,2,2,2,2,2,2,2,2,5,2,2,2,2,2,2,1,1,1,2,2,2,2,2,2,2,5,2,2,2,2,6
6,2,2,2,2,2,3,2,2,2,2,2,2,2,2,2,3,3,3,3,3,3,2,2,2,2,2,2,2,5,2,2,2,2,2,2,2,2,2,2,2,2,2,2,2,2,2,2,5,5,5,5,5,5,5,5,5,5,5,5,5,5,5,5,2,5,2,2,2,2,2,2,2,2,2,2,2,5,2,2,2,2,2,2,2,2,2,2,2,2,2,2,2,2,5,2,2,2,2,6
6,2,2,2,2,2,3,2,2,2,2,2,2,2,2,2,2,2,2,2,2,3,2,2,2,2,2,2,2,5,2,2,2,2,2,2,2,2,2,2,2,2,2,2,2,2,5,2,2,2,2,2,2,2,2,2,2,2,2,2,2,5,2,2,5,5,5,2,2,2,2,2,2,2,2,2,2,5,2,2,2,2,2,2,2,2,2,2,2,2,2,2,2,2,5,2,2,2,2,6
6,2,2,2,2,2,3,2,2,2,2,2,2,2,2,2,2,2,2,2,3,3,2,2,2,2,2,2,2,5,2,2,2,2,2,2,2,2,2,2,2,2,2,2,2,5,2,2,2,2,2,2,2,2,2,3,2,2,2,2,2,5,2,2,5,2,2,5,5,5,5,2,2,2,2,2,2,5,2,2,2,2,2,2,2,2,2,2,2,2,2,2,2,2,5,2,2,2,2,6
6,2,2,2,2,2,3,2,2,2,2,2,2,2,2,2,2,2,2,3,3,2,2,2,2,2,2,2,5,2,2,2,2,3,3,3,3,3,2,2,2,2,2,2,2,5,2,2,2,2,2,2,2,2,2,3,2,2,2,2,2,5,2,5,2,2,2,2,2,2,2,5,5,5,5,5,2,5,5,5,5,5,5,5,5,5,5,5,2,2,2,2,2,2,5,2,2,2,2,6
6,2,2,2,2,2,3,2,2,2,2,2,2,2,2,2,2,2,2,3,2,2,2,2,2,2,2,2,5,2,2,2,3,2,2,2,2,3,2,2,2,2,2,2,2,5,2,2,2,2,3,3,2,2,2,3,2,2,2,2,2,2,2,5,2,2,2,2,2,2,2,2,2,2,2,2,2,2,2,2,2,2,2,2,2,2,2,2,5,5,5,5,2,2,5,2,2,2,2,6
6,2,2,2,2,2,3,2,2,2,2,2,2,2,2,2,2,2,3,2,2,2,2,2,2,2,2,2,5,2,2,2,2,2,2,2,2,3,2,2,2,2,2,2,2,5,2,2,2,3,3,2,2,2,2,3,2,2,2,2,2,2,5,2,2,2,2,2,2,2,2,2,2,2,2,2,2,5,2,2,2,2,2,2,2,2,3,3,2,2,2,2,2,2,5,2,2,2,2,6
6,2,2,2,2,2,3,2,2,2,2,2,2,2,2,2,2,3,3,2,2,2,2,2,2,2,2,2,5,2,2,2,2,2,2,2,2,3,3,2,2,2,2,2,2,5,2,2,2,3,2,2,2,3,2,3,2,2,2,2,2,2,5,2,2,2,3,3,3,2,2,2,2,2,2,2,2,5,2,2,2,2,2,2,2,3,3,2,2,2,2,2,2,2,5,2,2,2,2,6
6,2,2,2,2,2,3,2,2,2,2,2,2,2,2,2,2,3,2,2,2,2,2,2,2,2,2,2,5,2,2,2,2,2,2,2,2,2,3,2,2,2,2,2,2,5,2,2,2,3,3,3,3,3,2,3,2,2,2,2,2,5,2,2,2,2,3,3,3,3,3,3,3,3,3,3,5,2,2,2,2,2,2,2,3,2,2,2,2,2,2,2,2,2,5,2,2,2,2,6
6,2,2,2,2,2,3,2,2,2,2,2,2,2,2,2,2,3,2,2,2,2,2,2,2,2,2,5,2,2,2,2,2,2,2,2,2,3,3,2,2,2,2,2,2,5,2,2,2,2,2,2,2,2,2,3,2,2,2,2,2,5,2,2,2,2,3,2,2,2,2,2,2,2,2,2,5,2,2,2,2,2,2,3,2,2,2,2,2,2,2,2,2,2,5,2,2,2,2,6
6,2,2,2,2,2,2,2,2,2,2,2,2,2,2,2,2,2,3,3,3,3,2,2,2,2,2,5,2,2,2,2,2,2,2,2,3,3,2,2,2,2,2,2,5,2,2,2,2,2,2,2,2,2,2,3,2,2,2,2,5,2,2,2,2,2,3,3,2,2,2,2,2,2,2,2,5,2,2,2,2,2,3,2,2,2,2,2,2,2,2,2,2,2,5,2,2,2,2,6
6,2,2,2,2,2,2,2,2,2,2,2,2,5,5,5,5,2,2,2,2,2,3,2,2,2,2,2,5,5,5,5,5,2,2,3,3,2,2,2,2,2,2,2,5,2,2,2,2,2,2,2,2,2,3,2,2,2,2,2,5,2,2,2,2,2,2,3,2,2,2,2,2,2,2,2,5,2,2,2,2,2,3,2,2,2,2,2,2,2,2,2,2,2,2,2,2,2,2,6
6,2,2,2,2,2,2,2,2,2,2,2,5,5,2,2,2,2,2,2,2,2,2,2,2,2,2,2,2,2,2,2,2,5,5,3,2,2,2,2,2,2,2,2,5,2,2,2,2,2,2,2,2,2,3,2,2,2,2,2,5,2,2,2,2,2,2,3,2,2,2,2,2,2,2,2,5,2,2,2,2,2,3,3,3,3,2,2,2,2,2,2,2,2,2,2,2,2,2,6
6,2,2,2,5,2,2,2,2,2,2,2,5,2,2,2,2,2,2,2,2,2,2,2,2,2,2,5,5,5,5,2,2,2,2,5,5,5,2,2,2,2,2,2,5,5,5,2,2,4,2,2,2,2,3,2,2,2,2,2,5,2,2,2,2,2,3,2,2,2,2,2,2,2,2,2,5,2,2,2,2,2,3,2,2,3,2,2,2,2,2,2,2,2,2,2,2,2,2,6
6,2,2,5,5,2,2,2,2,2,2,2,5,2,2,2,2,2,2,2,2,2,2,2,2,2,5,5,2,2,2,2,2,2,2,2,2,2,2,2,2,2,2,2,5,5,5,2,2,4,2,2,2,2,2,2,2,2,2,2,5,2,2,2,2,2,3,2,2,2,2,2,2,2,2,2,5,2,2,2,2,2,3,3,3,3,2,2,2,2,2,2,2,2,2,2,2,2,2,6
6,2,2,5,2,2,2,2,4,2,2,2,5,2,2,2,2,2,2,2,2,2,2,2,2,2,5,2,2,2,4,4,4,4,4,4,2,2,2,2,2,2,2,2,5,5,2,2,2,4,2,2,2,4,2,2,2,2,2,5,2,2,2,2,2,3,2,2,2,2,2,2,2,2,2,2,5,2,2,2,2,2,2,2,2,5,5,5,5,5,5,5,5,2,2,2,2,2,2,6
6,2,2,5,2,2,2,4,2,2,2,2,5,2,4,4,4,4,4,2,2,2,2,2,2,2,5,2,2,2,2,2,2,2,4,4,2,2,2,2,2,2,2,2,5,5,2,2,4,4,2,2,2,4,2,2,2,2,2,5,2,2,2,2,3,2,2,2,2,2,2,2,2,2,2,5,2,2,2,2,5,5,5,5,5,2,2,2,2,2,2,2,2,5,2,2,2,2,2,6
6,2,2,2,5,2,2,4,2,2,2,2,5,2,2,2,2,2,4,2,2,2,2,2,2,2,5,2,2,2,2,2,2,2,4,2,2,2,2,2,2,2,2,5,2,5,2,2,4,2,2,2,2,4,2,2,2,2,2,5,2,2,2,2,2,4,4,4,2,2,2,2,2,2,2,5,2,2,5,5,2,2,2,2,2,2,2,2,2,2,2,2,2,2,2,2,2,2,2,6
6,2,2,2,2,2,4,4,2,2,2,2,2,2,2,2,2,4,4,2,2,2,2,2,2,2,5,2,2,2,2,2,2,2,4,4,2,2,2,2,2,2,2,5,5,2,2,2,4,4,2,2,4,4,2,2,2,2,2,5,2,2,2,2,4,4,2,4,4,4,2,2,2,2,2,5,2,2,2,2,2,2,4,4,4,4,4,2,2,2,2,2,2,2,2,2,2,2,2,6
6,2,2,2,2,2,4,2,2,2,2,2,2,2,2,2,4,4,2,2,2,2,2,2,2,2,5,2,2,2,2,2,2,2,2,4,2,2,2,2,2,2,5,5,5,2,2,2,2,4,4,4,4,2,2,2,2,2,5,2,2,2,2,2,2,4,2,2,2,2,2,2,2,2,2,5,2,2,2,2,2,2,4,2,2,2,2,2,2,2,2,2,2,2,2,2,2,2,2,6
6,2,2,2,2,2,4,2,2,2,2,2,2,2,2,2,4,2,2,2,2,2,2,2,2,2,5,2,2,2,2,2,2,2,2,4,2,2,2,2,2,2,5,5,2,2,2,2,2,2,2,2,4,2,2,2,2,2,5,2,2,2,2,2,2,4,2,2,2,2,2,2,2,2,2,5,2,2,2,2,2,4,2,2,2,2,2,2,2,2,2,2,2,2,2,2,2,2,2,6
6,2,2,2,2,2,4,2,2,2,2,2,2,2,2,2,4,4,4,4,2,2,2,2,2,2,2,2,2,2,2,2,2,2,4,2,2,2,2,2,2,2,5,5,2,2,2,2,2,2,2,2,4,2,2,2,2,2,5,2,2,2,2,2,2,4,2,2,2,2,2,2,2,2,2,2,5,2,2,2,2,4,2,2,2,2,2,2,2,2,2,2,2,2,2,2,2,2,2,6
6,2,2,2,2,2,2,2,2,2,2,2,2,2,2,2,2,2,2,4,4,4,2,2,2,2,2,2,2,2,2,2,4,4,2,2,2,2,2,2,2,2,5,2,2,2,2,2,2,2,2,2,4,2,2,2,2,5,2,2,2,2,2,2,4,4,2,2,2,2,2,2,2,2,2,2,5,2,2,2,2,4,4,2,2,2,2,2,2,2,2,2,2,2,2,2,2,2,2,6
6,2,2,2,2,2,2,2,2,2,2,2,2,2,2,2,2,2,2,2,2,2,2,2,2,2,2,2,2,2,2,4,4,2,2,2,2,2,2,2,2,2,5,2,2,2,2,2,2,2,2,2,4,2,2,2,2,5,2,2,2,2,2,2,4,2,2,2,2,2,2,2,2,2,2,2,5,2,2,2,2,2,4,4,4,4,4,2,2,2,2,2,2,2,2,2,2,2,2,6
6,2,2,2,2,2,2,2,2,2,2,2,2,2,2,2,2,2,2,2,2,2,2,2,2,2,2,2,2,2,4,4,2,2,2,2,2,2,2,2,5,5,5,2,2,2,2,2,2,2,2,2,2,2,2,2,2,5,2,2,2,2,2,4,2,2,2,2,2,2,2,2,2,2,2,2,2,2,2,2,2,2,4,4,2,2,4,2,2,2,2,2,2,2,2,2,2,2,2,6
6,2,2,2,2,2,2,2,2,2,2,2,2,2,2,2,2,2,2,2,2,2,2,2,2,2,2,2,2,2,2,2,2,2,2,2,2,2,2,2,5,2,2,2,2,2,2,2,2,2,2,2,2,2,2,2,2,5,2,2,2,4,4,2,2,2,2,2,2,2,2,2,2,2,2,2,2,2,2,2,2,2,2,2,4,4,4,2,2,2,2,2,2,2,2,2,2,2,2,6
6,2,2,2,2,2,2,2,2,2,2,2,2,2,2,2,2,2,2,2,2,2,2,2,2,2,2,2,2,2,2,2,2,2,2,2,2,2,2,2,2,2,2,2,2,2,2,2,2,2,2,2,2,2,2,2,2,5,2,2,2,2,2,2,2,2,2,2,2,2,2,2,2,2,2,2,2,2,2,2,2,2,2,2,2,2,2,2,2,2,2,2,2,2,2,2,2,2,2,6
6,2,2,2,2,2,2,2,2,9,9,9,2,2,2,9,9,9,2,2,2,2,2,2,2,2,2,2,2,2,2,2,2,2,9,9,2,2,2,2,2,2,2,2,2,2,2,2,2,2,2,2,2,2,2,2,5,2,2,2,2,2,2,2,2,2,2,2,2,2,2,2,2,2,2,2,2,2,2,2,2,2,2,2,2,2,2,2,2,2,2,2,2,2,2,2,2,2,2,6
6,2,2,2,2,2,2,9,9,2,2,9,9,2,9,9,2,9,9,2,2,2,2,2,2,2,2,2,2,2,2,2,2,2,9,2,2,2,2,2,2,2,2,2,2,2,2,2,2,2,2,2,2,2,2,2,5,2,2,2,2,9,9,9,9,2,2,2,2,2,2,2,2,2,2,2,2,2,2,2,2,2,2,2,2,2,2,2,2,2,2,2,2,2,2,2,2,2,2,6
6,2,2,2,2,9,9,9,2,2,2,2,9,9,2,2,2,2,2,2,2,2,2,2,2,9,2,2,2,2,2,2,2,9,2,2,2,2,2,2,2,2,2,2,2,2,2,2,2,2,2,2,2,2,2,2,5,2,2,9,9,2,2,2,2,9,9,2,2,2,2,9,9,9,9,9,2,2,2,2,2,2,2,2,2,2,2,2,2,2,2,2,2,2,2,2,2,2,2,6
6,2,2,2,2,9,9,2,2,2,2,2,9,9,2,2,2,9,9,9,2,2,2,2,9,2,2,2,2,2,2,2,2,9,2,2,2,2,2,2,2,3,2,2,4,4,2,2,3,2,2,2,2,2,2,2,5,2,2,9,2,2,2,2,2,2,9,9,9,9,9,9,9,9,9,9,9,9,9,2,2,2,2,2,2,2,2,2,2,9,9,9,2,2,2,2,2,2,2,6
6,2,2,2,2,2,2,9,2,2,2,9,2,9,9,9,9,2,2,2,9,2,2,2,9,2,2,2,2,2,2,2,2,9,2,2,2,2,2,2,2,1,1,1,4,4,1,1,1,2,2,2,2,2,2,2,2,2,2,2,2,2,2,2,2,2,2,2,2,2,9,9,2,2,2,2,9,9,9,9,9,9,9,9,9,9,9,9,9,9,9,9,2,2,2,2,2,2,2,6
6,2,2,2,2,2,2,9,2,2,9,9,2,2,2,2,2,2,2,2,9,2,2,9,2,2,2,2,2,2,2,2,9,2,2,2,2,2,2,2,2,1,0,0,0,0,0,0,1,2,2,2,2,2,2,2,2,2,2,2,2,2,2,2,2,2,2,2,2,2,2,2,2,2,2,2,2,2,2,2,2,9,9,9,2,2,2,2,2,2,9,2,9,2,2,2,2,2,2,6
6,2,2,2,2,2,2,2,9,9,9,2,2,2,2,2,2,2,2,2,9,2,2,9,2,2,2,2,2,2,2,9,2,2,2,2,2,2,2,2,2,1,0,0,0,0,0,0,1,2,2,2,2,2,2,2,2,2,2,2,2,2,2,2,2,2,2,2,2,2,2,2,2,2,2,2,2,2,2,2,2,2,9,9,9,9,9,9,9,9,2,2,2,2,2,2,2,2,2,6
6,2,2,2,2,2,2,2,2,2,2,2,2,2,2,2,2,2,2,2,9,2,2,2,2,2,2,2,2,2,2,2,2,2,2,2,2,2,2,2,2,1,0,0,0,0,0,0,1,2,2,2,2,2,2,2,2,2,2,2,2,2,2,2,2,2,2,2,2,2,2,2,2,2,2,2,2,2,2,2,2,2,2,2,2,2,2,2,2,2,2,2,2,2,2,2,2,2,2,6
6,2,2,2,2,2,2,2,2,2,2,2,2,2,2,2,2,2,2,2,9,2,2,2,2,2,2,2,2,2,2,2,2,2,2,2,2,2,2,2,5,1,1,1,1,1,1,1,1,5,2,2,2,2,2,2,2,2,2,2,2,2,2,2,2,2,2,2,2,2,2,2,2,2,2,2,2,2,2,2,2,2,2,2,2,2,2,2,2,2,2,2,2,2,2,2,2,2,2,6
6,6,6,6,6,6,6,6,6,6,6,6,6,6,6,6,6,6,6,6,6,6,6,6,6,6,6,6,6,6,6,6,6,6,6,6,6,6,6,6,6,6,6,6,6,6,6,6,6,6,6,6,6,6,6,6,6,6,6,6,6,6,6,6,6,6,6,6,6,6,6,6,6,6,6,6,6,6,6,6,6,6,6,6,6,6,6,6,6,6,6,6,6,6,6,6,6,6,6,6
